...###
..##.#.####
.##..###..#
##..E.....#
#...@..#..#
###..###..#
..#..#....#
.##.##.#.##
.#..E...##
.#.....##
.#######