*******************
*1.#.#..###.#.#...*
*..#*#*#*.*.*#*.*#*
*####.####.###..##*
*#*#*#*#*.*#*.*#*.*
*.##.#.#.#...#.##.*
*.*#*#*#*.*.*#*#*.*
*#.##.#.##.###.#.#*
*#*#*#*.*.*.*.*.*#*
*..####..##....##.*
*.*.*#*#*#*.*.*#*#*
*#...###.##...#.#.*
*#*.*#*#*.*#*#*.*.*
*#...###.#...##...*
*.*.*#*#*#*.*.*.*#*
*..##.#...#....###*
*.*#*.*#*.*.*.*#..*
*#..###..##....#.2*
*******************
