###########
#@#.......#
#.#.#####.#
#.#.#...#.#
#.#.#.#.#.#
#.#.#.#.#.#
#.#.###.#.#
#.#.....#.#
#.#######.#
#.........#
###########