*******************
*1.###.#.#.#.##...*
*..#*.*.*#*.*.*.*.*
*###.##..##.....#.*
*#*#*.*.*#*#*.*#*#*
*#.##....###...###*
*.*.*#*.*.*#*#*.*.*
*####.####.#.#....*
*#*#*.*#*.*#*#*#*#*
*#####..#.....#.##*
*.*#*.*#*.*#*#*#*.*
*#.#....###.#...#.*
*.*#*#*#*#*.*#*#*.*
*..###.###.#..##..*
*.*.*#*#*.*#*#*#*#*
*.#.#######.#..###*
*.*.*.*#*#*.*#*#..*
*#.#####.###.###.2*
*******************
