*******************
*1.##..E.#..S.####*
*..#*.*.*#*.*.*M*.*
*K###.#..KM..S.#SE*
*.*.*.*#*.*.*#*#*.*
*...#.#S#####...#.*
*.*#*.*.*#*.*.*#*.*
*...#..##..##..#S#*
*.*#*.*.*#*.*#*.*#*
*.####.M#..#####E.*
*.*#*#*#*.*#*.*.*#*
*....M...##.#E.#..*
*.*#*#*.*#*.*#*#*.*
*.###.E.###.M..#.#*
*...*.*#*.*#*.*#*.*
*#..##.#....#..###*
*#*.....*#*.*#*#..*
*#M.##...........2*
*******************
