*******************
*1.###...#..####..*
*.E#*#*.*.*.*.*.*#*
*######.##.#..##..*
*#*.*#*.*.*#*#*#*.*
*.#####..#...#..##*
*#*#*#*#*.*#*.*.*#*
*.#.#...#...#...#.*
*#*.*#*.*#*#*#*.*.*
*..#....#.###....#*
*.*#*.*.*.*#*.*.*.*
*#.#...#.##..#.###*
*#*#*#*.*#*.*#*#*.*
*#.#.##...#..#.###*
*#*.*.*#*.*#*.*#*.*
*#..#.#..#####.###*
*#*#*.*.*.*.*.*#..*
*####.###.#....#.2*
*******************
