*******************
*1.#.##SM#..#####.*
*..#*#*.*#*#*.*.*.*
*###.##.#.#.....M#*
*#*#*#*E*.*.*#*#*.*
*...##.##.##S...##*
*#*#*#*.*.*.*.*#*.*
*#.#####.E.#E#..#.*
*#*.*.*.*#*.*.*#*#*
*####S#.#E#.M..#.#*
*#*.*.*#*.*.*.*.*.*
*S#####...S#.....#*
*#*#*.*.*#*#*.*.*#*
*.##.E.##...#S.M.S*
*.*.*#*.*#*#*.*#*#*
*##.##.#S#...#####*
*E*#*#*#*#*#*.*#..*
*#.###E#..###.##.2*
*******************
