*******************
*1.#..##.##.E#.#.M*
*..#*.*.*M*S*.*#*#*
*###.##.#..#...#..*
*.*#*#*#*E*#*#*#*#*
*E..###..M#....##.*
*#*#*#*.*#*#*.*#*#*
*.....M.#S###..#.M*
*#*#*.*S*#*.*#*.*#*
*.S.#..#....#...#.*
*M*#*#*.*#*.*.*.*#*
*..##.#....####...*
*.*#*.*M*#*.*#*.*.*
*.#..#.#..#.#####.*
*#*#*#*M*S*.*#*.*.*
*.###.####..#E####*
*S*.*.*E*#*#*#*#..*
*#M.M#.##..E#.##.2*
*******************
