*******************
*1.#....##.##.#.##*
*..#*#*.*#*#*.*#*.*
*####..##.##.#####*
*#*.*#*#*#*.*.*#*#*
*.##.##...##.#.#..*
*.*#*#*.*#*#*.*.*.*
*...##.#.E.....##.*
*#*.*.*.*#*#*.*#*#*
*#..#E........#...*
*#*.*#*.*.*.*.*.*.*
*E#E#..#.#####..EE*
*.*.*.*.*#*#*#*.*#*
*###..###..E#.##..*
*#*.*.*#*#*#*.*.*#*
*#.#..#.#.#E#.####*
*#*#*#*#*.*#*.*#..*
*###.#.#.#.....#.2*
*******************
