*******************
*1.###.###.##.##.#*
*..#*.*E*.*E*.*S*#*
*.####.K###.##S#..*
*.*.*.*#*#*E*#*.*#*
*K#.#S..E#...E#S#S*
*.*.*.*.*.*.*#*.*#*
*.#.####.#..S##.#S*
*.*#*S*#*#*M*M*.*.*
*....##M...#.##.#.*
*.*#*.*M*.*.*#*.*#*
*.M#.E...######.E#*
*.*.*#*#*#*.*#*#*.*
*.##...E#E..###.#.*
*.*#*#*.*#*#*.*.*#*
*.#..#..#.#..#.###*
*..................*
*##.##..##.###.#.2*
*******************
