*******************
*1.#...#....######*
*..#*.*E*#*#*#*#*.*
*####.##.###..#E#.*
*.*.*.*.*#*.*.*#*.*
*#.EE.##.##...####*
*.*S*.*.*#*M*.*.*#*
*.#E.#.....#..##.#*
*.*.*E*E*.*#*#*.*.*
*S...##...#.##..#.*
*#*.*#*.*.*.*#*.*M*
*##..#.K##.....S##*
*#*#*#*#*.*#*.*#*.*
*.##.S#..####..#.#*
*#*#*#*#*#*#*#*#*#*
*#ES###..###...###*
*.*#*#*.*.*E*.*#..*
*.####M.##.#.###.2*
*******************
