*******************
*1.#.#..##..#.#...*
*..#*#*#*.*.*#*.*#*
*######..#.#.#.###*
*.*#*.*.*#*.*#*.*#*
*#.##...##..##..##*
*#*.*#*#*#*#*.*.*.*
*####...##.#......*
*#*.*.*.*#*.*#*#*#*
*#.###..#...#...#.*
*.*#*.*#*.*#*#*.*.*
*#...#.####.###.#.*
*.*#*.*#*#*.*.*.*#*
*#.#.###..#.###..#*
*#*#*.*.*.*#*.*.*#*
*##....##.###.####*
*#*#*#*.*#*#*#*#..*
*#...####.#.##.#.2*
*******************
