*******************
*1.#.#.E..#.#####.*
*..#*#*.*.*.*E*#*E*
*###...#..S.M..E.#*
*.*#*.*#*E*#*#*#*#*
*.#..#.#..#...#.#.*
*.*#*#*#*E*E*.*.*#*
*M..##..EK..S...#.*
*#*#*.*#*#*.*#*.*#*
*..#S...S.#.E..###*
*#*#*.*#*.*.*.*#*M*
*.##.##.##..M.##E.*
*#*#*.*.*#*.*#*#*#*
*####..##..#...##.*
*.*#*#*#*.*E*.*M*.*
*...###M...M.#.###*
*.*#*#*.*#*#*.*#..*
*...#M#...E.####.2*
*******************
