*******************
*1.##S.##..#.#M###*
*..#*.*#*#*.*S*M*.*
*###.#.#...##.#E.E*
*#*S*#*#*#*.*.*.*S*
*###....###.#####M*
*#*.*#*#*#*#*.*#*#*
*M##.#.##.##.###E.*
*.*.*M*.*#*M*#*#*#*
*.#...##E#..E#.#.M*
*#*S*S*#*#*E*.*.*#*
*##E#...#.##..#..#*
*.*#*.*#*#*.*#*.*.*
*##....#.#M#.#.#..*
*.*#*.*S*#*.*#*#*.*
*.##...#.##....K##*
*#*#*.*#*.*.*.*#..*
*.##.##.#..M#..#.2*
*******************
