*******************
*1.###..##.###.#..*
*..#*.*#*.*.*#*.*.*
*###...#.....E....*
*.*.*.*.*#*#*.*#*.*
*#....####..#..##.*
*#*#*.*#*.*.*#*E*E*
*#########.#.#.##.*
*.*.*.*#*#*.*.*#*#*
*###.##...#..###..*
*.*#*.*#*.*.*.*.*.*
*.#.##...##.......*
*.*.*#*#*#*.*.*#*.*
*.###..####...#.##*
*#*#*#*#*.*.*.*.*#*
*.#..#.#....##.###*
*.*#*#*#*#*.*.*#..*
*...#..##...####.2*
*******************
