*******************
*1.#...#.###.#####*
*..#*#*#*.*#*.*.*.*
*######.....#.....*
*#*.*#*.*.*#*.*.*#*
*.####...##.###.#.*
*.*.*#*#*.*.*#*.*#*
*..##.#..#.......#*
*.*.*#*.*#*#*.*#*#*
*....###.########.*
*#*#*.*.*.*#*#*.*.*
*##.##.....#.###.#*
*.*.*#*.*#*#*.*.*.*
*#.##.#...#.####.#*
*.*.*.*#*.*.*.*#*.*
*...#..####.######*
*.*#*.*#*#*.*.*#..*
*#.#...##..##.##.2*
*******************
