*******************
*1.##..###..#S#.#S*
*..#*.*M*#*#*.*.*.*
*###.....S.E#.E#.#*
*#*.*M*#*E*#*S*#*.*
*###..####.#...#..*
*M*#*#*#*.*#*#*#*.*
*#.#.####S.##S....*
*#*#*#*#*#*.*.*.*#*
*..##MS.#.####.###*
*.*.*#*#*#*#*#*.*.*
*##.#....###S#...#*
*#*.*.*#*M*.*E*S*.*
*####.E...###....#*
*#*#*#*.*#*#*#*.*#*
*..##.###E.#..####*
*#*#*.*#*.*#*.*#..*
*..##.#ES#.##.##.2*
*******************
