*******************
*1.#.##.##...##.##*
*..#*.*.*#*#*#*.*.*
*#####.##...#..###*
*.*.*.*.*.*.*#*#*#*
*#..###...#......#*
*.*.*#*#*#*#*#*.*.*
*#..####..#...#.##*
*.*#*#*#*#*#*.*#*.*
*.#.#####.###.##.#*
*#*#*#*#*#*.*#*#*.*
*..###...#.#.#.#..*
*#*.*.*#*#*#*#*.*#*
*.......#.##.#.#.#*
*.*.*#*#*#*.*#*#*.*
*#.#.....#.#...###*
*.*.*#*#*#*#*#*#..*
*#.#.##..#.#..##.2*
*******************
