*******************
*1.#....#..#.##.#.*
*..#*#*#*#*#*E*.*E*
*###...#..#..##.##*
*#*#*#*#*#*#*.*S*.*
*S##.E#..E#....##.*
*#*.*.*.*E*.*#*#*.*
*#...#.EE#M..S###E*
*.*.*M*.*E*.*#*#*#*
*..M#...##E#...#E.*
*.*#*.*.*#*.*#*.*S*
*...#########.##..*
*.*#*.*.*.*#*#*#*.*
*..#.#SK##..M.###.*
*#*#*.*.*.*.*.*.*.*
*#.##.##M#.#..####*
*#*.*.*.*.*#*#*#..*
*.#M.###.#....M#.2*
*******************
