*******************
*1.##..SM.#S.#M.#.*
*..#*.*.*#*.*.*.*.*
*####..#.###.S.#.E*
*.*S*.*#*.*.*.*.*.*
*#...#......#..M#.*
*#*.*.*.*#*S*.*.*.*
*....##.###S..MS#.*
*.*.*#*#*#*#*#*.*.*
*##.##..#..#..###.*
*#*#*.*#*#*M*#*#*#*
*#.....##M#.#..##.*
*.*.*.*#*#*#*#*M*#*
*##.####....#.E#S#*
*#*#*.*.*#*.*E*E*#*
*.S#S#.#.#.#.EE###*
*.*#*.*.*#*.*.*#..*
*##.####...#E#.#.2*
*******************
