*******************
*1.#.#..........E#*
*..#*.*#*#*#*.*.*.*
*###...#....#.#.#E*
*#*#*.*.*#*E*#*.*#*
*.#.##.#.#.##.####*
*#*#*#*.*.*.*#*.*.*
*##.##......#..#.#*
*.*#*#*#*#*#*.*.*.*
*#..##.#..#.E.#..#*
*.*.*.*.*#*#*#*#*.*
*#.#..###...#.#.##*
*.*E*.*#*.*.*#*#*.*
*###.#.#..#..#....*
*#*#*.*.*#*#*#*.*.*
*..#E#..#.#.#..###*
*.*.*#*.*#*.*#*#..*
*.#.#..#...#...#.2*
*******************
