*******************
*1.##.S....M#.#..S*
*..#*#*.*.*S*.*.*.*
*#####S..##.....M.*
*#*#*#*#*.*#*E*.*.*
*.#M#..#.##.M#.##.*
*#*#*#*#*.*.*#*#*.*
*S..E#S..K#.##M###*
*#*.*.*.*S*#*#*.*.*
*..#.####..#S.##..*
*.*.*.*.*#*#*#*#*#*
*#..#E#.#....#####*
*.*.*.*#*#*.*#*.*.*
*#.###.#..##..####*
*.*#*.*.*.*E*E*.*.*
*..#######..S.M###*
*.*#*S*.*#*#*.*#..*
*S###.##.#S#E#.#.2*
*******************
