*******************
*1.#.M....S##...#.*
*..#*E*#*#*.*#*#*#*
*###ME...###.###..*
*.*M*.*#*.*.*.*#*.*
*..S.#####.####M..*
*#*.*#*.*#*.*#*#*.*
*#....#..#..###E#.*
*#*M*#*.*#*#*#*.*.*
*..#..#.#.#.#S..##*
*.*#*.*#*#*#*.*#*S*
*..##.M###..#.EK.#*
*#*E*#*S*.*.*.*#*#*
*E#.E##.#.M##.##SS*
*.*.*S*.*.*#*#*E*.*
*E###.#...#.##.###*
*.*S*.*.*#*#*#*#..*
*##.##.##E....##.2*
*******************
