*******************
*1.##.......#.####*
*..#*#*.*.*.*.*.*.*
*#####.#.....S##E#*
*.*.*.K.*#*.*M*#*S*
*....#E..#...##.E.*
*.*#*#*#*#*#*#*S*.*
*E..#..#..M..#...#*
*.*#*.*#*.*#*.*#*#*
*.E#...#...##.#.#.*
*#*#*#*.*.*#*.*#*.*
*#.#.###E.###...E.*
*.*E*.*.*.*.*#*#*#*
*#.M#.#....##E.#.M*
*#*S*S*.*#*#*.*#*#*
*...#.#...#....###*
*#*.*.*E*#*.*#*#..*
*.#...#...#.#..#.2*
*******************
