*******************
*1.###.#..#...##.#*
*..#*.*.*#*#*.*#*#*
*###..#.##.###..#.*
*.*#*.*#*.*#*.*.*#*
*.####..##..###...*
*#*.*.*#*.*.*.*#*.*
*##...###.###.#..#*
*.*#*.*.*.*.*.*#*.*
*##...###..##.##..*
*#*#*#*#*.*.*#*.*#*
*#..#..#.#.#..#.##*
*#*.*#*.*#*#*.*#*#*
*....#.#.##.#..##.*
*.*#*.*#*.*#*.*.*#*
*#.....##.####.###*
*#*.*#*#*.*#*#*#..*
*#.#.#..##.#.###.2*
*******************
