*******************
*1.#.*#*#*#*.*#*.#*
*..##.#..#...##..#*
*####*#*#*.*.*.*..*
*#.##..##.#.##.#.#*
**.*#*#*.*.*.*.*#.*
*.#..###...#######*
**.*#*.*#*.*.*.*.#*
*.#..##...##.###.#*
**.*#*.*#*.*#*#*..*
*..#.#.##.#..#.##.*
**.*.*.*#*#*#*#*#.*
*#.###.###.#.#.##.*
**.*.*.*.*#*.*.*..*
*####.###....##..#*
**.*.*.*.*#*.*####*
*##..##.#.#.####..*
*..#......##.#.#.2*
*******************
